人工知能じんこうちのうAIエーアイとは計算という	概念と
概念と	コンピュータという
コンピュータという	道具を
道具を	用いて
用いて	研究する
知能を	研究する
研究する	計算機科学の一分野を
計算機科学の一分野を	指す
指す	語
言語の	理解や
理解や	推論
推論	知的行動を
問題解決などの	知的行動を
知的行動を	代わって
人間に	代わって
代わって	行わせる
コンピューターに	行わせる
行わせる	技術
技術	される
または	される
計算機コンピュータによる	情報処理システムの
知的な	情報処理システムの
情報処理システムの	設計や
設計や	実現に関する
実現に関する	研究分野とも
研究分野とも	される
日本大百科全書ニッポニカの	解説で
解説で	述べている
情報工学者通信工学者の	佐藤理史は
佐藤理史は	述べている
次の	ように
ように	述べている
人間の	知的能力を
知的能力を	実現する
コンピュータ上で	実現する
実現する	技術ソフトウェアコンピュータシステム
様々な	技術ソフトウェアコンピュータシステム
応用例は	自然言語処理機械翻訳かな漢字変換構文解析等
自然言語処理機械翻訳かな漢字変換構文解析等	ある
専門家の	推論判断を
推論判断を	模倣する
模倣する	エキスパートシステム
エキスパートシステム	画像データを
画像データを	解析して
解析して	検出抽出したり
特定の	パターンを
パターンを	検出抽出したり
検出抽出したり	する
する	画像認識等が
画像認識等が	ある
1956年に	命名された
ダートマス会議で	命名された
ジョンマッカーシーにより	命名された
現在では	使われている
記号処理を	用いた
用いた	知能の
知能の	記述を
記述を	する
主体と	する
する	アプローチという
情報処理や	研究での
研究での	アプローチという
アプローチという	意味あいでも
意味あいでも	使われている
家庭用電気機械器具の	制御システムや
制御システムや	ゲームソフトの
ゲームソフトの	思考ルーチンも
思考ルーチンも	呼ばれることもある
こう	呼ばれることもある
プログラミング言語による	
	という
という	カウンセラーを
カウンセラーを	模倣した
模倣した	プログラム人工無脳が
プログラム人工無脳が	出されるが
しばしば	出されるが
引き合いに	出されるが
出されるが	なり
計算機に	させようという
人間の	専門家の
専門家の	役割を
役割を	させようという
させようという	エキスパートシステムと
エキスパートシステムと	呼ばれる
呼ばれる	研究情報処理システムの
研究情報処理システムの	実現は
実現は	なり
人間が	持つ
暗黙に	持つ
持つ	常識の
常識の	記述が
記述が	なり
問題と	なり
なり	困難視されている
実用への	利用が
利用が	困難視されている
人工的な	知能の
知能の	実現への
実現への	アプローチとしては
アプローチとしては	知られているが
ファジィ	理論や
理論や	ニューラルネットワークなどの
ニューラルネットワークなどの	ような
ような	アプローチも
アプローチも	知られているが
知られているが	人工知能であるGoodOldFashionedAIとの
従来の	人工知能であるGoodOldFashionedAIとの
人工知能であるGoodOldFashionedAIとの	差は
差は	ある
記述の	記号的明示性に
記号的明示性に	ある
その後	集めた
サポートベクターマシンが	集めた
注目を	集めた
また	ある
自らの	経験を
経験を	元に
元に	行う
学習を	行う
行う	強化学習という
強化学習という	手法も
手法も	ある
この	宇宙において
宇宙において	形質であるレイカーツワイルという
知性とは	強力な
最も	強力な
強力な	形質であるレイカーツワイルという
形質であるレイカーツワイルという	作業である
言葉通り	作業である
知性を	表現し
機械的に	表現し
表現し	実装するという
実装するという	ことは
ことは	作業である
極めて	重要な
重要な	作業である
2006年の	ディープラーニング深層学習の
ディープラーニング深層学習の	登場と
登場と	登場により
2010年代以降の	ビッグデータの
ビッグデータの	登場により
登場により	行った
一過性の	流行を
流行を	超えて
超えて	浸透して
社会に	浸透して
浸透して	行った
2016年から	2017年に
2017年に	かけて
かけて	導入した
ディープラーニングを	導入した
導入した	AIが
AIが	破り
完全情報ゲームである	囲碁などの
囲碁などの	トップ棋士
トップ棋士	プレイヤーも
さらに	不完全
不完全	情報ゲームである
情報ゲームである	ポーカーの
ポーカーの	プレイヤーも
世界トップクラスの	プレイヤーも
プレイヤーも	破り
破り	到達するなど
麻雀では	到達するなど
MicrosoftSuphxSuperPhoenixが	到達するなど
AIとして	初めて
初めて	到達するなど
十段に	到達するなど
到達するなど	なった
時代の	最先端技術と
最先端技術と	なった
第２次人工知能ブームでの	人工知能は
人工知能は	呼ばれ
機械学習と	呼ばれ
呼ばれ	ある
以下の	ような
ような	ものが
ものが	ある
一方	している例えばパラメータ調整コネクショニズムのシステム
計算知能CIは	している例えばパラメータ調整コネクショニズムのシステム
開発や	学習を
学習を	繰り返す
繰り返す	ことを
ことを	している例えばパラメータ調整コネクショニズムのシステム
基本と	している例えばパラメータ調整コネクショニズムのシステム
学習は	手法であり
経験に	基づく
基づく	手法であり
手法であり	関係している
非記号的AI	ない
美しく	ない
ない	AI
AI	ソフトコンピューティングと
ソフトコンピューティングと	関係している
その	手法としては
手法としては	ある
以下の	ものが
ものが	ある
これらを	統合した
統合した	知的システムを
知的システムを	作る
作る	試みも
試みも	なされている
ACTRでは	生成する
エキスパートの	推論ルールを
推論ルールを	ニューラル
統計的学習を	元に
元に	ニューラル
ニューラル	ネットワークや
ネットワークや	生成規則を
生成規則を	通して
通して	生成する
第3次人工知能ブームでは	出しており
ディープラーニングが	画像認識
画像認識	テキスト解析
テキスト解析	音声認識など
音声認識など	領域で
様々な	領域で
領域で	出しており
第2次人工知能ブームの	人工知能を
人工知能を	上回る
上回る	精度を
精度を	出しており
出しており	行われている
ディープラーニングの	研究が
研究が	行われている
盛んに	行われている
最近では	活躍している
DQN	CNN
CNN	RNN
RNN	GANと
GANと	様々な
様々な	ディープラーニングの
ディープラーニングの	派生が
派生が	でて
でて	活躍している
各分野で	活躍している
特に	見せている
GAN敵対的生成ネットワークは	加えて
ディープラーニングが	だしている
認識や	予測などの
予測などの	分野で
分野で	だしている
成果を	だしている
だしている	ことに
ことに	加えて
加えて	見せている
画像の	生成技術において
生成技術において	見せている
大きな	進化を
進化を	見せている
森正弥は	広がっており
これらの	成果を
成果を	背景に
背景に	広がっており
従来の	人工知能の
人工知能の	応用分野が
応用分野が	広がっており
広がっており	始まっていると
CreativeAIという	コンテンツ生成を
コンテンツ生成を	行っていく
行っていく	応用も
応用も	始まっていると
始まっていると	指摘している
AIの	構築が
構築が	試みられてきているが
長い	間
間	試みられてきているが
試みられてきているが	なってきた
シンボルグラウンディング問題と	フレーム問題の
フレーム問題の	解決が
解決が	なってきた
大きな	壁と
壁と	なってきた
17世紀初め	ルネデカルトは
ルネデカルトは	提唱した機械論
動物の	身体が
身体が	機械であると
ただの	機械であると
複雑な	機械であると
機械であると	提唱した機械論
ブレーズパスカルは	製作した
1642年	製作した
最初の	機械式計算機を
機械式計算機を	製作した
チャールズバベッジと	エイダラブレスは
エイダラブレスは	行った
プログラム可能な	機械式計算機の
機械式計算機の	開発を
開発を	行った
バートランドラッセルと	アルフレッドノースホワイトヘッドは
アルフレッドノースホワイトヘッドは	もたらした
数学原理を	出版し
出版し	もたらした
形式論理に	もたらした
革命を	もたらした
ウォーレンマカロックと	ウォルターピッツは
ウォルターピッツは	築いた
神経活動に	内在する
内在する	論理計算と
アイデアの	論理計算と
論理計算と	題する
題する	論文を
論文を	発表し
1943年に	発表し
発表し	築いた
ニューラルネットワークの	基礎を
基礎を	築いた
1950年代に	なると
なると	出始めた
AIに関して	出始めた
活発な	成果が
成果が	出始めた
ジョンマッカーシーは	作り出した
AIに関する	会議で
最初の	会議で
会議で	作り出した
人工知能という	用語を
用語を	作り出した
彼は	開発した
また	開発した
プログラミング言語を	開発した
知的ふるまいに関する	テストを
テストを	する
可能に	する
する	方法として
方法として	導入した
アランチューリングは	導入した
チューリングテストを	導入した
ジョセフワイゼンバウムはを	構築した
これは	おしゃべりロボットである
来談者中心療法を	行う
行う	おしゃべりロボットである
1956年に	行われた
行われた	使用され
ダートマス会議開催の	提案書において
提案書において	使用され
人類史上	用語として
用語として	使用され
初めて	使用され
使用され	創立された
新たな	分野として
分野として	創立された
1960年代と	1970年代の
1970年代の	間に
間に	示した
ジョエルモーゼスは	示した
プログラム中で	示した
積分問題での	記号的推論のパワーを
記号的推論のパワーを	示した
マービンミンスキーと	シーモアパパートは
シーモアパパートは	開発した
パーセプトロンを	出版して
出版して	単純な
単純な	ニューラルネットの
ニューラルネットの	限界を
限界を	示し
アランカルメラウアーは	開発した
プログラミング言語を	開発した
テッドショートリッフェは	示した
医学的診断と	療法における
療法における	ルールベースシステムを
ルールベースシステムを	構築し
構築し	示した
知識表現と	推論の
推論の	パワーを
パワーを	示した
これは	呼ばれることもある
最初の	エキスパートシステムと
エキスパートシステムと	呼ばれることもある
ハンスモラベックは	

障害物の	

ある	コースを
コースを	走行する
自律的に	走行する
走行する	コンピューター制御の
最初の	コンピューター制御の
コンピューター制御の	乗り物を
乗り物を	開発した
1980年代に	なった
ニューラルネットワークは	なった
バックプロパゲーションアルゴリズムによって	使われるように
広く	使われるように
使われるように	なった
また	提唱した
この	時代に
時代に	提唱した
ロドニーブルックスが	提唱した
知能には	必須との
身体が	必須との
必須との	学説身体性を
学説身体性を	提唱した
1990年代は	上げた
AIの	分野で
多くの	分野で
分野で	上げた
様々な	アプリケーションが
アプリケーションが	上げた
成果を	上げた
特に	敗れた
ボードゲームでは	目覚ましく
目覚ましく	開発し
1992年に	開発し
IBMは	開発し
世界チャンピオンに	匹敵する
匹敵する	バックギャモン専用コンピュータTDギャモンを
バックギャモン専用コンピュータTDギャモンを	開発し
開発し	打ち負かし
IBMの	チェス専用コンピュータディープブルーは
チェス専用コンピュータディープブルーは	打ち負かし
1997年5月に	打ち負かし
ガルリカスパロフを	打ち負かし
打ち負かし	敗れた
同年8月には	敗れた
オセロで	敗れた
日本電気の	オセロ専用コンピュータロジステロに
オセロ専用コンピュータロジステロに	敗れた
世界チャンピオンの	村上健が
村上健が	敗れた
国防高等研究計画局は	した
最初の	湾岸戦争において
湾岸戦争において	スケジューリングするのに
ユニットを	スケジューリングするのに
スケジューリングするのに	使い
AIを	使い
使い	上回った
これによって	省かれた
省かれた	コストが
コストが	上回った
1950年代以来の	AI研究への
AI研究への	投資全額を
政府の	投資全額を
投資全額を	上回った
上回った	ことを
ことを	した
明らかに	した
日本では	啓蒙し
甘利俊一日本学士院会員らが	啓蒙し
精力的に	啓蒙し
啓蒙し	発生したが
優秀な	成果も
成果も	発生したが
発生したが	指摘された
論理の	ブラックボックス性が
ブラックボックス性が	指摘された
1998年には	提唱されたが
非構造化データ形式の	XMLが
国際規格である	XMLが
XMLが	提唱されたが
提唱されたが	適用し
ここから	適用し
Web上の	非構造化データに対して
非構造化データに対して	適用し
アプリケーション別に	適した
適した	意味付けを
意味付けを	適用し
適用し	行わせる
処理を	行わせる
行わせる	試みが
試みが	開始された
同年に	提唱された
W3Cの	ティムバーナーズ
ティムバーナーズ	リーにより
Webに	行わせる
知的処理を	行わせる
行わせる	セマンティックウェブが
セマンティックウェブが	提唱された
この	技術は
技術は	行わせる
Web上の	データに
データに	付加して
意味を	付加して
付加して	行わせる
コンピュータに	行わせる
知的処理を	行わせる
行わせる	方法を
方法を	規格化する
国際的に	規格化する
規格化する	ものである
この	規格には
規格には	含まれている
知識工学における	オントロジーを
オントロジーを	表現する
表現する	データ形式の
データ形式の	OWLも
OWLも	含まれている
含まれている	ことから
ことから	分かる
かつて	流行した
流行した	亜種である
エキスパートシステムの	亜種である
亜種である	ことが
ことが	分かる
2000年代前半に	完了しているが
規格化が	完了しているが
完了しているが	していない
Web開発者にとっては	見出せなかった
開発工数に	見合うだけの
見合うだけの	メリットが
メリットが	見出せなかった
見出せなかった	ことから
ことから	していない
現在も	していない
普及は	していない
日本においては	流行した
エキスパートシステムの	流行の
流行の	後に
後に	流行した
ニューロファジィが	流行した
しかし	終焉した
研究が	進むにつれて
進むにつれて	直面し
計算リソースや	データ量の
データ量の	不足
不足	シンボルグラウンディング問題
シンボルグラウンディング問題	フレーム問題に
フレーム問題に	直面し
直面し	至る
産業の	在り方を
在り方を	激変させるような
激変させるような	AIに
AIに	至る
至る	ことは
ことは	無く
無く	終焉した
ブームは	終焉した
1980年代に	入って
入って	なり
大企業の	研究所を
研究所を	中心に
中心に	提案されるように
知識工学に	基づく
基づく	エキスパートシステムが
エキスパートシステムが	提案されるように
多数	提案されるように
提案されるように	なり
なり	立ち上がった
エキスパートシステムを	する
専門と	する
する	AIベンチャーも
AIベンチャーも	立ち上がった
次々と	立ち上がった
その	流行から
流行から	生まれた
生まれた	プロジェクトとして
究極の	プロジェクトとして
プロジェクトとして	挙げられる
第五世代コンピュータが	挙げられる
1982年から	1992年まで
1992年まで	費やして
日本は	費やして
国家プロジェクトとして	費やして
570億円を	費やして
費やして	進めるも
第五世代コンピュータの	研究を
研究を	進めるも
進めるも	必要で
採用した	知識工学的手法では
知識工学的手法では	必要で
膨大な	ルールの
ルールの	手入力が
手入力が	必要で
必要で	あり
専門家間で	異なる
専門知識の	解釈が
解釈が	異なる
異なる	場合には
場合には	行えない等の
統一した	ルール化が
ルール化が	行えない等の
行えない等の	問題も
問題も	あり
あり	至らなかった
実用的な	エキスパートシステムの
エキスパートシステムの	実現には
実現には	至らなかった
実現した	成果物は
成果物は	実行する
Prologの	命令を
命令を	解釈して
直接	解釈して
CPUの	ハードウェアの
ハードウェアの	機構で
機構で	解釈して
解釈して	実行する
高速に	実行する
実行する	Prolog専用機であるが
並列型の	Prolog専用機であるが
Prolog専用機であるが	見つからなかった
商業的な	意味で
意味で	見つからなかった
応用先が	見つからなかった
全く	見つからなかった
1980年代後半から	1990年代中頃に
1990年代中頃に	かけて
かけて	克服する
従来から	用いられてきた
電子制御の	手法として
手法として	用いられてきた
用いられてきた	ONOFF制御
ONOFF制御	PID制御
PID制御	現代制御の
現代制御の	問題を
問題を	克服する
克服する	ため
ため	研究され
知的制御が	研究され
盛んに	研究され
研究され	分類する
知識工学的な	ルールを
ルールを	用いる
用いる	ファジィ制御
ファジィ制御	データの
データの	特徴を
特徴を	学習して
学習して	分類する
分類する	ニューラルネットワーク
ニューラルネットワーク	ニューロファジィという
その	2つを
2つを	融合した
融合した	ニューロファジィという
ニューロファジィという	手法が
手法が	迎えた
日本を	中心に
中心に	迎えた
ブームを	迎えた
バブル期の	高級路線に
高級路線に	合わせて
合わせて	増やし
白物家電製品でも	増やし
センサの	個数と
個数と	種類を
種類を	増やし
大幅に	増やし
増やし	発売され
多様な	データを
データを	元に
元に	最適化する
運転を	最適化する
最適化する	モデルが
モデルが	発売され
多数	発売され
発売され	始めた
ファジィについては	事から
2018年までに	取得している
日本が	取得している
世界の	15の
15の	特許を
特許を	取得している
取得している	事から
事から	なっていた
日本で	大きな
特に	大きな
大きな	ブームと
ブームと	なっていた
なっていた	ことが
ことが	分かっている
現在の	白物家電では
白物家電では	用いられているが
この	当時より
当時より	発展した
更に	発展した
発展した	制御技術が
制御技術が	用いられているが
用いられているが	なり
既に	当たり前の
当たり前の	ものに
ものに	なり
なり	意識されなく
利用者には	意識されなく
意識されなく	なっている
ニューロファジィが	なった
ブームに	なった
なった	1990年代には
1990年代には	ビッグデータという
未だ	ビッグデータという
ビッグデータという	概念は
概念は	無くブロードバンド接続普及後の
無くブロードバンド接続普及後の	行われなかった
2010年に	提唱された
初めて	提唱された
提唱された	行われなかった
データマイニングとしての	産業応用は
産業応用は	行われなかった
しかし	言える
ニューラルネットワークが	巻き込んで
一般人も	巻き込んで
巻き込んで	流行した
流行した	事例としては
事例としては	事例であり
初めての	事例であり
事例であり	言える
2010年代の	ディープラーニングブームの
ディープラーニングブームの	前史とも
前史とも	言える
言える	社会現象と
社会現象と	言える
松下電器が	活かすファジィ
1985年頃から	活かすファジィ
人間が	持つような
持つような	曖昧さを
曖昧さを	活かすファジィ
制御に	活かすファジィ
制御についての	研究を
研究を	開始し
開始し	漕ぎ着けた
1990年2月1日に	ファジィ
ファジィ	洗濯機第1号である
洗濯機第1号である	愛妻号Dayファジィの
愛妻号Dayファジィの	発売に
発売に	漕ぎ着けた
愛妻号Dayファジィは	世界初であった
従来よりも	収集した
多数の	センサーで
センサーで	収集した
収集した	データに
データに	基づいて
基づいて	世界初であった
柔軟に	最適化する
運転を	最適化する
最適化する	洗濯機で
洗濯機で	世界初であった
同種の	洗濯機としては
洗濯機としては	世界初であった
ファジィ制御という	マッチした
当時	マッチした
最先端の	技術の
技術の	導入が
導入が	マッチした
バブル期の	高級路線にも
高級路線にも	マッチした
マッチした	ことから
ことから	集めた
ファジィは	制御技術であるにも関わらず
裏方の	制御技術であるにも関わらず
制御技術であるにも関わらず	集めた
世間の	注目を
大きな	注目を
注目を	集めた
その	流行の
流行の	度合いは
度合いは	選ばれる程であった
1990年の	新語流行語大賞における
新語流行語大賞における	金賞で
新語部門の	金賞で
金賞で	選ばれる程であった
ファジィが	選ばれる程であった
その後に	ファジィ
松下電器は	ファジィ
ファジィ	開発し
ルールの	チューニングを
煩雑な	チューニングを
チューニングを	自動化した
自動化した	ニューロファジィ制御を
ニューロファジィ制御を	開発し
開発し	突破して
従来の	ファジィ理論の
ファジィ理論の	限界を
限界を	突破して
突破して	評価されるだけでなく
学会で	評価されるだけでなく
評価されるだけでなく	巻き起こした
白物家電への	応用にも
応用にも	成功して
成功して	巻き起こした
更なる	ブームを
ブームを	巻き起こした
松下電器の	試みの
試みの	成功を
成功を	受けて
受けて	発売した
他社も	発売した
同様の	知的制御を
知的制御を	用いる
用いる	製品を
製品を	発売した
多数	発売した
1990年代中頃までは	用いられており
メーカー各社による	白物家電の
一般向けの	白物家電の
白物家電の	売り文句として
売り文句として	用いられており
知的制御技術の	名称が
名称が	用いられており
大々的に	用いられており
用いられており	付与されていた
洗濯機の	製品名では
製品名では	付与されていた
愛妻号DAYファジィ	分類としては
掃除機の	分類としては
分類としては	ニューロファジィ掃除機
ニューロファジィ掃除機	運転モードでは
エアコンの	運転モードでは
運転モードでは	付与されていた
ニューロ自動などの	名称が
名称が	付与されていた
ニューロ	ファジィ
ファジィ	ニューロファジィという
ニューロファジィという	手法は
手法は	あった
従来の	オンオフ制御や
単純な	オンオフ制御や
オンオフ制御や	モデル化するこの作業は対象が複雑な
対象を	モデル化するこの作業は対象が複雑な
数式で	モデル化するこの作業は対象が複雑な
客観的に	モデル化するこの作業は対象が複雑な
モデル化するこの作業は対象が複雑な	機構を
機構を	持つ
持つ	場合は
場合は	なる
極めて	難しく
難しく	なる
なる	必要が
必要が	ある
ある	PID制御や
PID制御や	現代制御等と
現代制御等と	比較して
比較して	抑えながら
人間の	経験則や
主観的な	経験則や
経験則や	計測した
計測した	データの
データの	特徴が
特徴が	なる
利用可能と	なる
なる	ファジィ
ファジィ	ニューロ
ニューロ	ニューロファジィは
ニューロファジィは	抑えながら
開発工数を	抑えながら
抑えながら	できるという
環境適応時の	柔軟性を
柔軟性を	できるという
高く	できるという
できるという	利点が
利点が	あった
しかし	迎えた
開発者らの	努力にも関わらず
努力にも関わらず	少なさから
計算能力や	データ量の
収集可能な	データ量の
データ量の	少なさから
少なさから	迎えた
既存の	工作機械や
工作機械や	家電製品の
家電製品の	制御を
制御を	改善する
多少	改善する
改善する	程度で
程度で	迎えた
限界を	迎えた
理論的にも	ファジィ
ファジィ	不可能な
集合と	深層学習が
深層学習が	不可能な
不可能な	ニューラルネットワークの
ニューラルネットワークの	組み合わせであり
組み合わせであり	与えられたとしても
計算リソースや	データが
データが	与えられたとしても
潤沢に	与えられたとしても
与えられたとしても	あった
認識精度の	向上には
向上には	あった
限界が	あった
以降	進まず
計算機の	能力限界から
能力限界から	進まず
理論の	改善は
改善は	進まず
遅々と	して
して	進まず
進まず	無くなり
目立った	進展は
進展は	無くなり
無くなり	なった
1990年代末には	なった
知的制御を	搭載する
搭載する	白物家電が
白物家電が	なった
大多数に	なった
なった	ことで
ことで	去った
売り文句としての	ブームは
ブームは	去った
ブーム後は	なったが
一般には	意識されなく
意識されなく	なったが
なったが	使われ
現在では	使われ
裏方の	技術として
技術として	使われ
家電製品のみならず	使われ
雨水の	排水
排水	駐車場
駐車場	管理システムなどの
ビルの	管理システムなどの
管理システムなどの	社会インフラにも
社会インフラにも	使われ
使われ	実証されている
十分に	実証されている
性能と	安定性が
安定性が	実証されている
2003年頃には	発展した
人間が	設計した
設計した	オントロジーファジィルールとして表現するを
オントロジーファジィルールとして表現するを	利活用する
利活用する	ネットワークインテリジェンスという
ネットワークインテリジェンスという	分野に
分野に	発展した
2005年	著作で
レイカーツワイルは	著作で
著作で	超越し
圧倒的な	人工知能が
人工知能が	超越し
知識知能の	点で
点で	超越し
人間を	超越し
超越し	担い
科学技術の	進歩を
進歩を	担い
担い	世界を
世界を	変革する
変革する	技術的特異点シンギュラリティが
技術的特異点シンギュラリティが	訪れると
2045年にも	訪れると
訪れると	する
する	説を
説を	発表した
2006年に	提案された
ジェフリーヒントンらの	研究チームにより
研究チームにより	提案された
オートエンコーダによる	ニューラルネットワークの
ニューラルネットワークの	深層化手法が
深層化手法が	提案された
提案された	現在のディープラーニングの直接的な起源
2010年代に	入り
入り	整備された
膨大な	データを
データを	扱う
扱う	研究開発の
研究開発の	ための
ための	環境が
環境が	整備された
整備された	ことで
ことで	前進し始めた
AI関連の	研究が
研究が	前進し始めた
再び	前進し始めた
大きく	前進し始めた
2010年に	提唱された
英国エコノミスト誌で	提唱された
ビッグデータという	用語が
用語が	提唱された
同年に	ワトソンが
質問応答システムの	ワトソンが
ワトソンが	勝利し
クイズ番組ジェパディの	練習戦で
練習戦で	勝利し
人間に	勝利し
勝利し	なった
大きな	ニュースと
ニュースと	なった
2012年に	優勝した
画像処理コンテストで	優勝した
ジェフリーヒントン氏の	チームが
チームが	優勝した
従来手法からの	精度改善を
大幅な	精度改善を
精度改善を	果たした上で
果たした上で	優勝した
優勝した	ことで
ことで	始まった
第三次AIブームが	始まった
2013年には	発表した
国立情報学研究所や	富士通研究所の
富士通研究所の	研究チームが
研究チームが	開発した
開発した	東ロボくんで
東ロボくんで	挑んだと
東京大学入試の	模擬試験に
模擬試験に	挑んだと
挑んだと	発表した
数式の	計算や
計算や	解析に
単語の	解析に
解析に	あたる
あたる	専用プログラムを
専用プログラムを	使い
使い	解読した
実際に	臨んだ
受験生が	臨んだ
臨んだ	大学入試センター試験と
大学入試センター試験と	東大の
東大の	2次試験の
2次試験の	問題を
問題を	解読した
代々木ゼミナールの	判定では
判定では	難しいが
東大の	合格は
合格は	難しいが
難しいが	合格できる
私立大学には	合格できる
合格できる	水準だった
2014年には	提唱された
日本の	人工知能学者である
人工知能学者である	齊藤元章により
齊藤元章により	先立ち
特異点に	先立ち
先立ち	プレシンギュラリティという
オートメーション化と	コンピューター技術の
コンピューター技術の	進歩により
進歩により	近づくという
衣食住の	生産コストが
生産コストが	近づくという
ゼロに	限りなく
限りなく	近づくという
プレシンギュラリティという	概念も
概念も	提唱された
ジェフホーキンスが	続けているが
実現に	向けて
向けて	続けているが
研究を	続けているが
続けているが	展開している
著書考える脳考えるコンピューターの	中で
中で	自己連想記憶理論という
自己連想記憶理論という	理論を
独自の	理論を
理論を	展開している
世界各国において	進んでいるが
軍事民間共に	進んでいるが
実用化に	向け
向け	進んでいるが
研究開発が	進んでいるが
進んでいるが	留まった
とくに	進行しているものの
無人戦闘機や	無人自動車ロボットカーの
無人自動車ロボットカーの	開発が
開発が	進行しているものの
進行しているものの	留まった
2010年代には	留まった
まだ	留まった
完全な	自動化は
自動化は	留まった
試験的な	ものに
ものに	留まった
留まった	UCAVは
UCAVは	利用されているが
利用されているが	多い
一部操作は	行っている
地上から	行っている
行っている	ものが
ものが	多い
ロボット向けとしては	登場している
CSAILの	ロドニーブルックスが
ロドニーブルックスが	提唱した
提唱した	包摂アーキテクチャという
包摂アーキテクチャという	理論が
理論が	登場している
これは	ものではなく
従来型の	知が
我思う故に	我ありの
我ありの	知が
知が	先行する
先行する	ものではなく
ものではなく	神経ネットワークのみを
体の	神経ネットワークのみを
神経ネットワークのみを	用いて
用いて	学習する
環境から	学習する
学習する	行動型システムを
行動型システムを	用いている
これに	基づいた
基づいた	ゲンギスと
ゲンギスと	呼ばれる
呼ばれる	ロボットは
六本足の	ロボットは
ロボットは	持たないにも関わらず
いわゆる	脳を
脳を	持たないにも関わらず
持たないにも関わらず	行動する
まるで	生きているかの
生きているかの	ように
ように	行動する
2015年10月に	勝利して
米DeepMind社が	作成した
作成した	AlphaGoが
AlphaGoが	勝利して
人間の	プロ囲碁棋士に
プロ囲碁棋士に	勝利して
勝利して	注目され
以降は	注目され
ディープラーニングと	呼ばれる
手法が	注目され
注目され	進められている
人工知能自体の	研究の
研究の	他にも
他にも	進められている
人工知能が	与える
雇用などに	与える
与える	影響についても
影響についても	進められている
研究が	進められている
2016年10月	人工知能技術
DeepMindが	導き出す
入力された	情報の
情報の	関連性を
関連性を	導き出し
導き出し	仮説に
仮説に	近い
近い	ものを
ものを	導き出す
導き出す	人工知能技術
ディファレンシャブルニューラルコンピューターを	発表し
発表し	開発
同年11月	開発
大量の	データが
データが	不要の
不要の	ワンショット学習を
ワンショット学習を	する
可能に	する
する	深層学習
深層学習	システムを
システムを	開発
翌2017年6月	開発
関係推論の	ような
ような	認識能力を
人間並みの	認識能力を
認識能力を	持つ
持つ	システムを
システムを	開発
2017年8月には	解決した
記号接地問題シンボルグラウンディング問題を	解決した
2006年の	ディープラーニングの
ディープラーニングの	発明と
発明と	整備
2010年以降の	ビッグデータ収集環境の
ビッグデータ収集環境の	整備
整備	高性能化により
計算資源と	なる
なる	GPUの
GPUの	高性能化により
高性能化により	優勝した
2012年に	優勝した
ディープラーニングが	優勝した
画像処理コンテストで	優勝した
他の	手法に
手法に	付けて
圧倒的	付けて
大差を	付けて
付けて	優勝した
優勝した	ことで
ことで	持って
技術的特異点という	概念は
概念は	持って
急速に	集め
世界中の	識者の
識者の	注目を
注目を	集め
集め	持って
現実味を	持って
持って	受け止められるように
受け止められるように	なった
ディープラーニングの	発明と
発明と	普及を
急速な	普及を
普及を	受けて
受けて	立ち上げられている
研究開発の	現場においては
現場においては	立ち上げられている
デミスハサビス率いる	DeepMindを
DeepMindを	筆頭に
筆頭に	Vicarious
Vicarious	IBMCortical
IBMCortical	Learning
Learning	Center
Center	全脳アーキテクチャ
全脳アーキテクチャ	PEZYComputing
PEZYComputing	OpenCog
OpenCog	GoodAI
GoodAI	nnaisense
nnaisense	IBMSyNAPSE等
IBMSyNAPSE等	汎用人工知能AGIを
汎用人工知能AGIを	開発する
開発する	プロジェクトが
プロジェクトが	立ち上げられている
数多く	立ち上げられている
これらの	研究開発の
研究開発の	現場では
現場では	されている
脳を	リバースエンジニアリングして
リバースエンジニアリングして	構築された
構築された	神経科学と
神経科学と	機械学習を
機械学習を	組み合わせる
組み合わせる	アプローチが
アプローチが	されている
有望と	されている
結果として	提唱され
HierarchicalTemporalMemoryHTM理論	SystemsCLS理論の
ComplementaryLearning	SystemsCLS理論の
SystemsCLS理論の	更新版等
更新版等	タスクのみを
単一の	タスクのみを
タスクのみを	扱う
扱う	ディープラーニングから
ディープラーニングから	進んだ
更に	一歩
一歩	進んだ
進んだ	提唱され
複数の	タスクを
タスクを	扱う
同時に	扱う
扱う	理論が
理論が	提唱され
提唱され	始めている
3Dゲームの	ような
ような	仮想空間で
仮想空間で	動かし
モデルを	動かし
動かし	現実世界の
現実世界の	ことを
ことを	学ばせるといった
高速に	学ばせるといった
学ばせるといった	ことも
ことも	上げているシミュレーションによる学習
大きな	成果を
成果を	上げているシミュレーションによる学習
また	いる
数は	少ないが
少ないが	あると
AGIだけでは	不可能と
知能の	再現は
再現は	不可能と
不可能と	考えて
考えて	再現するために
身体知を	再現するために
再現するために	必要だと
全人体シミュレーションが	必要だと
必要だと	する
する	研究者や
研究者や	AL人工生命の
より	近い
生物に	近い
近い	振る舞いを
振る舞いを	見せる
見せる	AL人工生命の
AL人工生命の	作成に
作成に	挑む
挑む	研究者
研究者	知能と
知能と	関係に
密接な	関係に
関係に	あると
あると	思われる
思われる	デジタル的再現人工意識に
意識の	デジタル的再現人工意識に
デジタル的再現人工意識に	挑戦する
挑戦する	研究者も
研究者も	いる
リーズナブルな	コストで
コストで	なった
大量の	計算リソースが
計算リソースが	入るように
手に	入るように
入るように	なった
なった	ことで
ことで	出現し
ビッグデータが	出現し
出現し	寄せており
企業が	寄せており
膨大な	データの
データの	活用に
活用に	強い
極めて	強い
強い	関心を
関心を	寄せており
寄せており	展開されている
全世界的に	行って
民間企業主導で	行って
莫大な	投資を
投資を	行って
行って	展開されている
人工知能に関する	研究開発競争が
研究開発競争が	展開されている
また	始めている
2011年の	DWaveSystemsによる
DWaveSystemsによる	量子アニーリング方式の
量子アニーリング方式の	製品化を
製品化を	して
嚆矢と	して
して	実用化され
量子コンピュータという	超々並列処理が
超々並列処理が	可能な
可能な	ITインフラが
次世代の	ITインフラが
ITインフラが	実用化され
急速に	実用化され
実用化され	始めた
始めた	事で
事で	解決できる
人工知能の	高速化にも
高速化にも	関わる
深く	関わる
関わる	組み合わせ最適化問題を
組み合わせ最適化問題を	解決できる
リアルタイムに	解決できる
解決できる	環境が
環境が	整備され
整備され	始めている
この	動向を
動向を	受ける
受ける	形で
形で	なった
2016年頃から	なった
一般向けの	ニュース番組でも
ニュース番組でも	なった
人工知能の	研究開発や
研究開発や	サービス展開や
新しい	サービス展開や
サービス展開や	報道が
量子コンピュータに関する	報道が
報道が	なった
目立つように	なった
2017年には	するために
イーロンマスクが	するために
急速に	進化し続ける
進化し続ける	人工知能に対して
人工知能に対して	取らないように
人間が	取らないように
遅れを	取らないように
取らないように	するために
するために	研究開発する
人間の	脳を
脳を	接続する
機械に	接続する
接続する	ブレインマシンインターフェースを
ブレインマシンインターフェースを	研究開発する
研究開発する	ニューラリンク社を
ニューラリンク社を	立ち上げていた
立ち上げていた	ことを
ことを	公表し
公表し	なった
世界中で	なった
話題に	なった
ブレインマシンインターフェースにより	予測されている
人の	インターネットが
インターネットが	出現する
出現する	事が
事が	予測されている
2017年10月には	提唱された
ジェフリーヒントンにより	学習できる
要素間の	位置関係まで
相対的な	位置関係まで
位置関係まで	含めて
含めて	学習できる
学習できる	カプセルネットワークが
カプセルネットワークが	提唱された
2018年3月16日の	提言によると
国際大学GLOCOMの	提言によると
提言によると	分析されている
課題解決型の	AIを
AIを	活用する
活用する	事で
事で	寄与できると
社会変革に	寄与できると
寄与できると	分析されている
2018年8月	実装し
OpenAIが	実装し
好奇心を	実装し
実装し	ノーゲームスコア
ノーゲームスコア	ノーゴール
ノーゴール	公表
無報酬で	行う
目的	なき
なき	探索を
探索を	行う
行う	AIを
AIを	公表
これまでの	AIで
AIで	人間らしいと
最も	人間らしいと
人間らしいと	いう
2018年9月	開発した
MITリンカーン研究所は	開発した
従来ブラックボックスであった	ニューラルネットワークの
ニューラルネットワークの	推論を
推論を	どのような
どのような	段階を
段階を	経て
経て	識別したのかが
識別したのかが	分かる
明確に	分かる
分かる	アーキテクチャを
アーキテクチャを	開発した
2019年に	入ると
入ると	あり
これまで	深層学習では
深層学習では	されてきた
困難と	されてきた
されてきた	言語処理において
言語処理において	あり
大きな	進展が
進展が	あり
あり	至った
Wikipediaなどを	使用した
使用した	読解テストで
読解テストで	至った
人間を	上回るに
上回るに	至った
BERT	ROBERT
ROBERT	

アメリカでは	発表
2013年に	時の
時の	大統領バラクオバマが
大統領バラクオバマが	発表
脳研究プロジェクトを	発表
Googleは	開発している
アレン脳科学研究所と	連携し
連携し	開発している
脳スキャンによって	生まれた
生まれた	データを
大量の	データを
データを	処理するための
処理するための	ソフトウェアを
ソフトウェアを	開発している
2016年の	時点で
時点で	達していると
Googleが	管理している
管理している	データ量は
Brainmapの	データ量は
データ量は	達していると
すでに	達していると
1Zettaバイトに	達していると
達していると	いう
Googleは	始めており
ドイツの	マックスプランク研究所とも
マックスプランク研究所とも	始めており
共同研究を	始めており
始めており	再構成するという
脳の	電子顕微鏡写真から
電子顕微鏡写真から	再構成するという
神経回路を	再構成するという
再構成するという	研究を
研究を	行っている
中国では	立ち上げ
2016年の	第13次5カ年計画から
第13次5カ年計画から	位置づけ
AIを	位置づけ
国家プロジェクトに	位置づけ
位置づけ	立ち上げ
脳研究プロジェクトとしても	立ち上げ
立ち上げ	推進してる
官民一体で	推進してる
AIの	研究開発を
研究開発を	推進してる
中国の	教育機関では
教育機関では	投じられてもいる
18歳以下の	天才児を
天才児を	集めて
集めて	投じられてもいる
公然と	AI兵器の
AI兵器の	開発に
開発に	投じられてもいる
マサチューセッツ工科大学MITの	教授やなどによれば
教授やなどによれば	あると
中国では	あると
プライバシー意識の	強い
強い	欧米と
欧米と	比較して
比較して	あると
AIの	研究や
研究や	新技術の
新技術の	実験を
実験を	しやすい
しやすい	環境に
環境に	あると
あると	されている
日本で	推進している
スーパーコンピュータの	研究開発を
研究開発を	推進している
推進している	齊藤元章も
齊藤元章も	主張している
AIの	開発において
開発において	リードする
中国が	リードする
リードする	可能性を
可能性を	主張している
世界の	ディープラーニング用計算機の
ディープラーニング用計算機の	4分の3は中国が占めてる
4分の3は中国が占めてる	ともされる
米国政府によれば	なっている
2013年から	なっている
ディープラーニングに関する	論文数では
論文数では	なっている
中国が	超えて
米国を	超えて
超えて	なっている
世界一と	なっている
やなどAIの	独占している
世界的な	大会でも
大会でも	独占している
中国勢が	独占している
上位を	独占している
大手AI企業Google	マイクロソフト
マイクロソフト	アップルなどの
アップルなどの	幹部でもあった
幹部でもあった	台湾系アメリカ人科学者のは
台湾系アメリカ人科学者のは	を著して
中国が	握りつつあると
AIで	握りつつあると
覇権を	握りつつあると
握りつつあると	する
を著して	取り上げた
アメリカの	政界や
政界や	メディアなどが
メディアなどが	取り上げた
フランス大統領エマニュエルマクロンは	宣言し
AI分野の	開発支援に
開発支援に	向け
向け	宣言し
5年で	15億ドル約1600億円を
15億ドル約1600億円を	支出すると
支出すると	宣言し
宣言し	開き
AI研究所を	開き
パリに	開き
開き	招致した
フェイスブック	グーグル
グーグル	サムスン
サムスン	DeepMind
DeepMind	富士通などを
富士通などを	招致した
イギリスとも	決定されている
AI研究における	連携も
長期的な	連携も
連携も	決定されている
EU全体としても	方向
Horizon2020計画を通じて	方向
215億ユーロが	投じられる
投じられる	方向
韓国は	する
20億ドルを	する
2022年までに	する
投資を	する
6つの	AI機関を
AI機関を	設立し
設立し	作られた
褒賞制度も	作られた
目標は	ことだと
2022年までに	入る
AIの	世界トップ4に
世界トップ4に	入る
入る	ことだと
ことだと	いう
日経新聞調べによると	2位中国
国別の	AI研究論文数は
AI研究論文数は	米国
1位	米国
2位中国	3位
3位	7位だった
インドで	7位だった
日本は	7位だった
プログラミング言語は	使われている
Cの	ほか
ほか	Pythonが
Pythonが	使われている
広く	使われている
深層学習を	利用するには
利用するには	なる
微分	線形代数
線形代数	確率統計といった
確率統計といった	数学知識が
大学レベル以上の	数学知識が
数学知識が	なる
必要と	なる
脳シミュレーションを	行うには
行うには	なる
脳神経科学の	知識も
知識も	なる
重要と	なる
人工知能学会の	松尾豊は
松尾豊は	否定しているが
著書	否定しているが
人工知能は	超えるか
人間を	超えるか
超えるか	於いて
内に	於いて
於いて	起こす
人間に対して	起こす
反乱を	起こす
起こす	可能性を
可能性を	否定しているが
否定しているが	いる
人工知能の	危険性について
危険性について	鳴らしている
警鐘を	鳴らしている
鳴らしている	著名人も
著名人も	いる
MITの	教授は
教授は	変わると
莫大な	資金力と
資金力と	人権の
人権の	弾圧を
弾圧を	併せ持つ
併せ持つ	中華人民共和国が
中華人民共和国が	成功すれば
人工知能の	開発競争で
開発競争で	成功すれば
成功すれば	優位という
民主的な	国家が
国家が	優位という
技術革新に	優位という
優位という	既成概念が
既成概念が	変わると
変わると	述べ
述べ	鳴らしており
ディープラーニングの父の	一人と
一人と	呼ばれているは
呼ばれているは	鳴らしており
中国が	利用している
市民の	監視や
監視や	政治目的で
政治目的で	利用している
人工知能を	利用している
利用している	ことに
ことに	鳴らしており
警鐘を	鳴らしており
鳴らしており	AI独裁と
海外の	人権団体や
人権団体や	メディアなどは
メディアなどは	AI独裁と
中国に	代表される
代表される	人工知能で
人工知能で	抑圧する
人権を	抑圧する
抑圧する	政治体制を
政治体制を	デジタル独裁
デジタル権威主義	デジタル独裁
デジタル独裁	デジタル警察国家
デジタル警察国家	デジタル全体主義
デジタル全体主義	AI独裁と
AI独裁と	呼んだ
中国では	埋め込んだ
ヘルメットや	帽子に
帽子に	埋め込んだ
埋め込んだ	センサーから
センサーから	監視する
国民の	脳波と
脳波と	感情を
感情を	監視する
人工知能で	監視する
監視する	政府支援の
政府支援の	プロジェクトが
プロジェクトが	推し進められ
推し進められ	行わせ
ネット検閲と	官僚や
官僚や	囚人から
刑務所の	囚人から
囚人から	歩行者まで
横断歩道の	歩行者まで
歩行者まで	行わせ
監視を	行わせ
人工知能に	行わせ
行わせ	顔認識
監視カメラと	警察の
警察の	サングラス型スマートグラスや
サングラス型スマートグラスや	ロボットに
ロボットに	顔認識
顔認識	システム天網を
システム天網を	搭載するなど
搭載するなど	行われている
人工知能による	監視社会管理社会化が
監視社会管理社会化が	行われている
新疆ウイグル自治区では	あると
監視カメラや	携帯電話などから
携帯電話などから	収集した
収集した	個人情報を
個人情報を	解析するや
人工知能で	解析するや
解析するや	選別した
人種プロファイリングで	選別した
選別した	ウイグル族を
少数民族の	ウイグル族を
ウイグル族を	経ずに
法的手続きを	経ずに
経ずに	犯す
2017年6月時点で	約1万5千人も
約1万5千人も	犯す
テロや	犯罪を
犯罪を	犯す
犯す	可能性が
可能性が	あると
あると	して
して	報じられており
新疆ウイグル再教育キャンプに	予防拘禁していると
予防拘禁していると	する
する	内部文書であるが
中国政府の	内部文書であるが
内部文書であるが	報じられており
報じられており	ないと
AIを	使った
使った	政府による
政府による	コンピュータが
特定の	民族の
民族の	選別や
選別や	コンピュータが
コンピュータが	送る
人間を	送る
強制収容所に	送る
送る	人権侵害は
人権侵害は	ないと
前例が	ないと
ないと	して
して	なっている
国際問題に	なっている
香港では	恐れ
中国本土と	同様の
同様の	監視社会化を
人工知能による	監視社会化を
監視社会化を	恐れ
恐れ	香港民主化デモが起きた
2019年	香港民主化デモが起きた
香港民主化デモが起きた	際は
際は	破壊された
監視カメラを	搭載した
搭載した	スマート街灯が
スマート街灯が	破壊された
市民に	破壊された
次々と	破壊された
中国は	輸出しており
AI監視技術を	輸出しており
中東アジアアフリカなど	世界各国に
世界各国に	輸出しており
輸出しており	懸念されている
国際連合の専門機関である	国際電気通信連合ITUを通じて
国際電気通信連合ITUを通じて	主導してる
中国が	主導してる
AI監視技術の	国際標準化も
国際標準化も	主導してる
主導してる	ことから
ことから	拡散する
中国の	ような
ような	人権侵害が
人権侵害が	拡散する
世界に	拡散する
拡散する	ことが
ことが	懸念されている
人権団体などから	懸念されている
中国の	社会信用システムに
社会信用システムに	代表されるような
代表されるような	活用して
人工知能で	活用して
ビッグデータを	活用して
活用して	決める
人々の	適性を
適性を	決める
決める	制度は
制度は	あり
社会階層間の	格差を
格差を	固定化する
固定化する	ことに
ことに	繋がると
繋がると	する
する	懸念が
懸念が	あり
あり	施行された
欧州連合では	施行された
2018年5月から	認めない
人工知能のビッグデータ分析のみによる	認めない
雇用や	融資での
融資での	差別を
差別を	認めない
認めない	EU一般データ保護規則が
EU一般データ保護規則が	施行された
マサチューセッツ工科大学が	顔認識
顔認識	達したのに対して
システムの	精度で
精度で	達したのに対して
Microsoftと	中国の
中国の	Megviiは
Megviiは	達したのに対して
9割超で	達したのに対して
IBMは	達したのに対して
8割に	達したのに対して
達したのに対して	発表した
Amazonは	発表した
6割で	あると
人種差別的な	バイアスが
バイアスが	あると
あると	する
する	研究を
研究を	発表した
発表した	なった
際は	なった
Amazonと	論争に
論争に	なった
主要国の	軍隊は
軍隊は	試みている
ミサイル防衛の	分野での
分野での	自動化を
自動化を	試みている
アメリカ海軍は	破壊できる
完全自動の	防空システム
防空システム	ファランクスCIWSを
ファランクスCIWSを	導入しガトリング砲により
対艦ミサイルを	破壊できる
イスラエル軍は	所有し
対空迎撃ミサイルシステム	アイアンドームを
アイアンドームを	所有し
所有し	稼働させて
ガザ地区との	境界線には
境界線には	検知する
標的を	検知する
自動	検知する
検知する	ガーディアムや
ガーディアムや	サムソンRCWSを
サムソンRCWSを	稼働させて
稼働させて	射殺している
複数の	人間を
人間を	射殺している
今後	生み
AIは	生み
新しい	軍事能力を
軍事能力を	生み
生み	変え
軍の	指揮
指揮	訓練
訓練	展開を
部隊の	展開を
展開を	変え
変え	一変させ
戦争を	一変させ
一変させ	決めることになるとの
その	変化は
変化は	決めることになるとの
大国間の	軍事バランスを
軍事バランスを	決めることになるとの
決めることになるとの	主張も
主張も	ある
P1哨戒機の	ように
ように	搭載されることもある
戦闘指揮システムに	搭載されることもある
支援用に	搭載されることもある
2016年6月	発表された
米シンシナティ大学の	研究チームが
研究チームが	開発した
開発した	ALPHAは
ALPHAは	発表された
元米軍パイロットとの	模擬空戦で
模擬空戦で	勝利したと
一方的に	勝利したと
勝利したと	発表された
AIプログラムは	使用しており
遺伝的アルゴリズムと	ファジィ
ファジィ	使用しており
制御を	使用しており
使用しており	動作可能
アルゴリズムの	動作に
動作に	高い
高い	処理能力は
処理能力は	必要と
必要と	せず
RaspberryPi上で	動作可能
アメリカ合衆国	国防総省は
国防総省は	出し
人道上の	観点から
観点から	介さない
人間の	判断を
判断を	介さない
介さない	開発禁止令を
自律殺傷兵器の	開発禁止令を
開発禁止令を	出し
2012年に	出し
出し	した
2017年には	した
これを	恒久的な
恒久的な	ものに
ものに	した
人工知能に	勝ち残る力として
人間が	勝ち残る力として
勝ち残る力として	注目されている
OODAループが	注目されている
一部の	科学者や
科学者や	ハイテク企業の
ハイテク企業の	首脳らは
首脳らは	主張している
AIの	軍事利用により
軍事利用により	加速すると
世界の	不安定化は
不安定化は	加速すると
加速すると	主張している
2015年に	開催された
ブエノスアイレスで	開催された
開催された	人工知能国際合同会議で
人工知能国際合同会議で	創業者のイーロン・マスク
スティーブンホーキング	アメリカ宇宙ベンチャー企業の
アメリカ宇宙ベンチャー企業の	スペースX
スペースX	創業者のイーロン・マスク
創業者のイーロン・マスク	出されたが
アップル社の	共同創業者の
共同創業者の	スティーブウォズニアックら
スティーブウォズニアックら	企業家らにより
科学者と	企業家らにより
企業家らにより	出されたが
公開書簡が	出されたが
出されたが	とらえられ
そこには	とらえられ
自動操縦による	銃火器を
無人爆撃機や	銃火器を
銃火器を	操る
操る	人型
ロボットなど	AI搭載型兵器は
AI搭載型兵器は	とらえられ
火薬	核兵器に
核兵器に	続く
続く	革命と
第3の	革命と
革命と	とらえられ
とらえられ	予測
うち	なると
一部は	なると
数年以内に	なると
実用可能と	なると
なると	予測
国家の	不安定化
不安定化	暗殺
暗殺	抑圧
抑圧	民族への
特定の	民族への
民族への	選別攻撃などに
選別攻撃などに	利用され
利用され	記された
兵器の	開発競争が
開発競争が	ならないと
人類にとって	有益な
有益な	ものとは
ものとは	ならないと
ならないと	記された
同年4月には	求めている
ハーバード大学	ロースクールと
ロースクールと	国際人権団体である
国際人権団体である	ヒューマンライツウォッチが
ヒューマンライツウォッチが	求めている
自動操縦型武器の	禁止を
禁止を	求めている
2017年11月には	行われ
国際連合で	行われ
AIの	軍事利用に関する
軍事利用に関する	初の
初の	公式専門家会議が
公式専門家会議が	行われ
行われ	盛り込まれなかった
2019年8月に	採択するも
同会議は	採択するも
AI兵器の	運用をめぐる
運用をめぐる	国際ルールを
事実上初の	国際ルールを
国際ルールを	採択するも
採択するも	盛り込まれなかった
法的拘束力は	盛り込まれなかった
新冷戦や	米中冷戦の
米中冷戦の	状態に
状態に	あるとも
あるとも	評されている
評されている	米国中国ロシアは
米国中国ロシアは	行っている
核開発に	匹敵する
匹敵する	開発競争を
開発競争を	めぐって
人工知能の	軍事利用を
軍事利用を	めぐって
めぐって	行っている
中国は	発表し
2017年6月に	成功した
119機の	ドローン群の
ドローン群の	自律飛行実験で
自律飛行実験で	成功した
前年2016年に	成功した
103機の	飛行実験に
飛行実験に	成功した
成功した	米軍の
米軍の	記録を
記録を	更新して
更新して	発表し
翌2018年5月には	発表し
北米の	都市を
都市を	爆撃する
爆撃する	映像も
CGの	映像も
映像も	発表し
発表し	行うなど
同年6月には	行うなど
56隻の	自律無人艇を
自律無人艇を	使った
使った	世界最大規模の
世界最大規模の	試験を
試験を	行うなど
行うなど	統合運用で
AIの	軍事利用の
軍事利用の	技術特にスウォームと
技術特にスウォームと	呼ばれる
呼ばれる	統合運用で
大量の	徘徊型兵器などの
徘徊型兵器などの	自律兵器の
自律兵器の	統合運用で
統合運用で	進展しており
中国が	進展しており
急速に	進展しており
進展しており	されている
アメリカに	追い付く
追い付く	可能性が
可能性が	ある
ある	ことについて
ことについて	懸念し
懸念し	あるとの
アメリカ側では	あるとの
将来に	備える
備える	必要が
必要が	あるとの
あるとの	主張も
主張も	されている
中国の	軍用AI開発は
軍用AI開発は	与え
アメリカの	軍部や
軍部や	政界に
政界に	与え
危機感を	与え
与え	協力していると
2019年3月に	ジョセフダンフォード統合参謀本部議長や
ジョセフダンフォード統合参謀本部議長や	パトリックシャナハン国防長官代行
パトリックシャナハン国防長官代行	ドナルドトランプ大統領は
ドナルドトランプ大統領は	協力していると
中国での	AI研究拠点の
AI研究拠点の	設立などで
設立などで	協力していると
中国人民解放軍に	協力していると
協力していると	非難し
Googleを	非難し
非難し	面談して
Googleの	CEOサンダーピチャイは
CEOサンダーピチャイは	面談して
ダンフォードや	トランプ大統領と
トランプ大統領と	面談して
面談して	釈明する
中国の	AI研究拠点の
AI研究拠点の	成果は
成果は	釈明する
中国に限らず	開放されていると
全ての	人々に
人々に	開放されていると
開放されていると	釈明する
釈明する	事態に
事態に	なった
アメリカでは	極秘計画
Googleが	協力する
米軍の	AIの
AIの	軍事利用に
軍事利用に	協力する
協力する	極秘計画
極秘計画	行っていた
メイヴン計画を	行っていた
行っていた	ことが
ことが	暴露されており
Googleの	社員に
社員に	暴露されており
暴露されており	受けた
2018年12月の	公聴会では
アメリカ議会の	公聴会では
公聴会では	受けた
同様に	暴露された
暴露された	中国政府に
中国政府に	協力する
協力する	秘密計画と
秘密計画と	ともに
ともに	誓った
人工知能を	用いた
用いた	兵器開発や
兵器開発や	人権侵害は
人権侵害は	拒否すると
拒否すると	誓った
Googleが	誓った
誓った	人工知能開発6原則との
同年6月の	人工知能開発6原則との
人工知能開発6原則との	整合性で
整合性で	受けた
追及を	受けた
中国軍の	戦闘機J20の
戦闘機J20の	標的選択支援アルゴリズムに
標的選択支援アルゴリズムに	報道された際は
グーグルの	AI研究者が
AI研究者が	関わったと
関わったと	報道された際は
報道された際は	否定した
AIではなく	モデリングと
統計学的な	モデリングと
モデリングと	否定した
また	呼んだ
Microsoftが	呼んだ
中国軍の	教育機関と
教育機関と	共同研究を
AIの	共同研究を
共同研究を	発表した
発表した	際も
際も	呼んだ
同様に	呼んだ
波紋を	呼んだ
2019年11月に	構築しているだけでなく
マークエスパー国防長官は	構築しているだけでなく
中国が	構築しているだけでなく
AIによって	構築しているだけでなく
新しい	監視国家を
監視国家を	構築しているだけでなく
構築しているだけでなく	販売している
中東で	拡散させて
翼竜や	彩虹など
彩虹など	拡散させて
無人攻撃機を	拡散させて
大量に	拡散させて
拡散させて	攻撃する
AIで	攻撃する
自律的に	攻撃する
攻撃する	ドローン兵器も
ドローン兵器も	販売している
販売している	ことに
ことに	鳴らした
警鐘を	鳴らした
ロシアと	中国は
中国は	実用化してると
既に	実用化してると
実用化してると	される
される	自動化の
ハッキングの	自動化の
自動化の	他
他	なりすましたり
特定の	個人を
個人を	攻撃したり
攻撃したり	なりすましたり
ディープフェイクで	なりすましたり
なりすましたり	挙げられている
ボット投稿により	挙げられている
世論を	挙げられている
操る等の	懸念が
懸念が	挙げられている
Googleは	発表した
2019年3月	指導するために
人工知能プロジェクトを	指導するために
倫理面で	指導するために
指導するために	構成される
哲学者政策立案者経済学者テクノロジスト等で	構成される
構成される	設置すると
AI倫理委員会を	設置すると
設置すると	発表した
しかし	要請した
倫理委員会には	含まれており
反科学反マイノリティ地球温暖化懐疑論等を	支持する
支持する	人物も
人物も	含まれており
含まれており	要請した
Google社員らは	要請した
解任を	要請した
4月4日	理由で
Googleは	判明したという
倫理委員会が	機能できない
期待どおりに	機能できない
機能できない	ことが
ことが	判明したという
判明したという	理由で
理由で	発表した
委員会の	解散を
解散を	発表した
東洋哲学を	吸収させるという
AIに	吸収させるという
吸収させるという	テーマに
三宅陽一郎の	テーマに
テーマに	応じて
応じて	挙げ
井口尊仁は	挙げ
鳥居TORIIという	プロジェクトを
自分の	プロジェクトを
プロジェクトを	挙げ
挙げ	語る
われわれは	アニミズムで
アニミズムで	見いだす
あらゆる	ものに
ものに	見いだす
霊的存在を	見いだす
見いだす	文化が
文化が	ありますと
ありますと	語る
三宅	立石従寛に
および	立石従寛に
立石従寛に	語る
アニミズム的人工知能論は	現代アートや
現代アートや	論じた
禅の	悟りを
悟りを	やって
どう	やって
やって	やらせるかを
AIに	やらせるかを
論じた	通じている
三宅の	人工知能のための哲学塾東洋哲学篇にも
人工知能のための哲学塾東洋哲学篇にも	通じている
元	Google
Google	エンジニアの
エンジニアの	アンソニー
アンソニー	レバンドウスキーは
レバンドウスキーは	創立している
2017年	創立している
AIを	する
神と	する
する	宗教団体
宗教団体	WayoftheFuture未来の道を
WayoftheFuture未来の道を	創立している
団体の	使命は
使命は	表現されており
人工知能AIに	基づいた
基づいた	実現を
Godheadの	実現を
実現を	促進し
促進し	開発する
開発する	こと
こと	ことと
そして	ことと
Godheadの	理解と
理解と	崇拝を
崇拝を	通して
通して	する
社会を	する
より	良く
良く	する
する	ことに
ことに	貢献する
貢献する	ことと
ことと	表現されており
抽象的に	表現されており
表現されており	報道した
多くの	海外メディアは
海外メディアは	報道した
SF映画や	歴史などと
歴史などと	関連付けて
関連付けて	報道した
Uberと	Googleの
Googleの	Waymoは
Waymoは	行っている
レバンドウスキーが	盗用した
自動運転に関する	機密情報を
機密情報を	盗用した
盗用した	ことを
ことを	訴え
訴え	行っている
裁判を	行っている
行っている	一方
一方	征服するんだと
レバンドウスキーは	征服するんだと
Uberの	元CEOトラビスカラニックに対し
元CEOトラビスカラニックに対し	ボットひとつずつ
ボットひとつずつ	征服するんだと
我々は	征服するんだと
世界を	征服するんだと
征服するんだと	発言するなど
発言するなど	示している
野心的な	振る舞いを
振る舞いを	示している
相愛大学人文学部	教授の
教授の	釈徹宗は
釈徹宗は	なってきていますと
哲学や	思想や
思想や	文学と
文学と	線引きも
宗教や	霊性論との
霊性論との	線引きも
線引きも	なってきていますと
不明瞭に	なってきていますと
なってきていますと	述べている
哲学者倫理学者である	内田樹によれば
内田樹によれば	いう
	いう
本物の	哲学者は
哲学者は	していると
みんな	していると
死者と	幽霊と
幽霊と	異界の
異界の	話を
話を	していると
していると	いう
発明家レイカーツワイルが	言うには
言うには	論争は
哲学者ジョンサールが	提起した
提起した	AIの
強い	AIと
AIと	弱い
弱い	AIの
AIの	論争は
論争は	話題である
AIの	哲学議論で
哲学議論で	ホットな
ホットな	話題である
哲学者ジョンサール	ダニエルデネットによると
および	ダニエルデネットによると
ダニエルデネットによると	主張している
サールの	部屋や
中国語の	部屋や
部屋や	ネドブロックらの
ネドブロックらの	中国脳といった
中国脳といった	思考実験は
機能主義に	批判的な
批判的な	思考実験は
思考実験は	主張している
真の	意識が
意識が	実現できないと
形式論理システムによって	実現できないと
主張している	実現できないと
科学を	語るとは
語るとは	ことかにおいて
どういう	ことかにおいて
ことかにおいて	指摘している
科学者の	須藤靖は
須藤靖は	指摘している
科学についての	哲学的考察科学哲学が
哲学的考察科学哲学が	指摘している
実際には	指摘している
科学と	断絶している
ことを	指摘している
また	脳科学計算機科学コンピュータ科学
心や	意識という
意識という	問題を
問題を	解明してきた
解明してきた	脳科学計算機科学コンピュータ科学
	批判している
人工知能研究開発等に	関連して
関連して	批判している
科学者の	フランシスクリックは
フランシスクリックは	批判している
哲学者たちは	2000年という
2000年という	間
長い	間
間	残して
ほとんど	残して
何も	残して
成果を	残して
残して	こなかったと
こなかったと	批判している
こう	した
した	観点において
観点において	評価されている
哲学は	学問科学に過ぎないと
二流どころか	三流の
三流の	学問科学に過ぎないと
学問科学に過ぎないと	評価されている
脳科学者の	澤口俊之は
澤口俊之は	賛同し
クリックに	賛同し
賛同し	述べている
これは	なるが
私の	愚痴に
ため息まじりの	愚痴に
愚痴に	なるが
なるが	思うと
哲学者や	思想家というのは
思想家というのは	思うと
つくづく	暇だと
暇だと	思うと
思うと	述べている
実際	伝えており
哲学は	始まったと
暇（スコレー）から	始まったと
始まったと	伝えており
アリストテレスが	伝えており
伝えており	的外れではないと
上記の	ような
ような	否定的発言も
否定的発言も	的外れではないと
的外れではないと	言う
科学哲学者の	野家啓一は
野家啓一は	言う
哲学者は	してきた
科学とは	違う
違う	日常的言語で
日常的言語で	語ろうと
存在や	宇宙を
宇宙を	語ろうと
語ろうと	してきた
しかし	信用していなかった
理論物理学者ディラックは	信用していなかった
哲学者を	信用していなかった
ことさら	信用していなかった
ディラックが	見たところ
見たところ	理解していない
ウィトゲンシュタインを	含め
含め	哲学者たちは
哲学者たちは	理解していない
量子力学どころか	理解していない
パスカル以降の	確率の
確率の	概念さえ
概念さえ	理解していない
非科学的な	日常的言語を
日常的言語を	使っても
いくら	使っても
使っても	できないというのが
正確な	意思疎通を
意思疎通を	行う
行う	ことは
ことは	できないというのが
できないというのが	されている
ディラックの	考えだと
考えだと	されている
生命情報科学者神経科学者の	合原一幸編著
合原一幸編著	論じられているが
人工知能は	創られるによれば
こう	して
して	創られるによれば
創られるによれば	論じられているが
AIの	発展に
急激な	発展に
発展に	伴って
伴って	論じられているが
技術的特異点シンギュラリティの	思想や
思想や	哲学が
哲学が	論じられているが
一部で	論じられているが
論じられているが	話ではない
特異点と	言っても
言っても	話ではない
数学的な	話ではない
前掲書は	記している
そもそも	超えるという
シンギュラリティと	関係した
関係した	議論における
議論における	脳を
人間の	脳を
脳を	超えるという
超えるという	言明自体が
言明自体が	定義できていないと
うまく	定義できていないと
定義できていないと	記している
確かに	捉える
脳を	捉える
デジタル情報処理システムとして	捉える
捉える	観点から
観点から	見れば
見れば	起こり得るかもしれない
シンギュラリティは	起こり得るかもしれない
しかし	示されている
実際の	脳は
脳は	ハイブリッド系である
その	ような
ような	システムではなく
単純な	システムではなく
システムではなく	ハイブリッド系である
デジタルと	アナログが
アナログが	融合した
融合した	ハイブリッド系である
ハイブリッド系である	ことが
ことが	示されている
脳神経科学の	観察結果で
観察結果で	示されている
前掲書によると	存在し
神経膜では	存在し
様々な	ノイズが
ノイズが	存在し
存在し	生み出されている
この	ノイズ付きの
ノイズ付きの	アナログ量によって
アナログ量によって	生み出されている
脳内の	ニューロンの
ニューロンの	カオスが
カオスが	生み出されている
生み出されている	ため
ため	考えられている
この	ような
ような	状況を
状況を	記述する
デジタルで	記述する
記述する	ことは
ことは	考えられている
極めて	困難と
困難と	考えられている
数学者の	田中一之は
田中一之は	述べており
一般の	哲学者は
哲学者は	専門家ではないと
論理の	専門家ではないと
専門家ではないと	述べており
述べており	計算機科学者コンピュータ科学者電子工学者のトルケル
フランセーンは	批判している
哲学者たちによる	言及の
数学的な	言及の
言及の	多くが
多くが	批判している
ひどい	誤解や
誤解や	自由連想に
自由連想に	基づいていると
基づいていると	批判している
田中によると	書いた
ゲーデルの	不完全性定理について
不完全性定理について	書いた
哲学者が	書いた
書いた	本が
本が	販売されていたが
フランセーンの	本と
本と	同じ
同じ	頃に
頃に	販売されていたが
書店	販売されていたが
販売されていたが	酷評された
哲学者の	本は
本は	酷評された
専門誌によって	酷評された
その	本は
本は	高かったが
全体として	読みやすく
読みやすく	高かったが
一般読者からの	評判は
評判は	高かったが
高かったが	説明していた
ゲーデルの	証明の
証明の	核不動点定理について
核不動点定理について	説明していた
根本的な	勘違いを
勘違いを	した
した	まま
まま	説明していた
同様の	間違いは
間違いは	見られる
他の	入門書などにも
入門書などにも	見られる
フランセーンによれば	誤解
不完全性定理に関する	誤解
誤用は	起こっており
哲学をはじめ	起こっており
一般に	起こっており
起こっており	乱用されている
宗教や	神学でも
神学でも	乱用されている
1931年に	示したのは
ゲーデルが	示したのは
示したのは	定理ではない
特定の	形式体系
形式体系	存在であり
formula1において	存在であり
決定不能な	命題の
命題の	存在であり
一般的な	意味での
意味での	不完全性についての
不完全性についての	定理ではない
科学と	哲学

科学を	語るとは
語るとは	ことかによると
どういう	ことかによると
ことかによると	なった
学問の	扱う
扱う	問題が
問題が	整理され
整理され	分化した
分化した	ことで
ことで	なった
科学と	哲学も
哲学も	異なる
それぞれ	異なる
異なる	問題を
問題を	研究するように
研究するように	なった
これは	言う
研究分野の	細分化
細分化	その
ものであり立派な	進歩だと
進歩だと	言う
宇宙物理学者の	須藤は
須藤は	言う
一方で	言及した
科学哲学者倫理学者の	伊勢田哲治は
伊勢田哲治は	扱う
様々な	要素を
要素を	含んだ
含んだ	問題を
大きな	問題を
問題を	扱う
哲学的統一的に	扱う
扱う	言及した
かつての	天文学について
天文学について	言及した
	返している
その後の	天文学では
天文学では	なりましたし
その	哲学的
哲学的	なりましたし
問題を	扱わなく
扱わなく	なりましたし
なりましたし	返している
今の	物理学でも
物理学でも	扱わないと
そう	いう
いう	問題を
問題を	扱わないと
扱わないと	述べた
述べた	伊勢田に対し
伊勢田に対し	返している
須藤は	返している
その	通りですが
通りですが	あるのでしょうかと
それ自体に	あるのでしょうかと
何か	あるのでしょうかと
問題が	あるのでしょうかと
あるのでしょうかと	返している
須藤は	述べた
次の	ようにも
ようにも	述べた
須藤は	取り上げて
哲学的に	論じられている
論じられている	原因という
原因という	言葉を
言葉を	取り上げて
取り上げて	定義しない
原因という	言葉を
言葉を	定義しない
具体的に	定義しない
定義しない	限り
限り	不可能ですと
それ以上の	議論は
議論は	不可能ですと
不可能ですと	述べており
述べており	している
哲学者が	持っている
興味を	持っている
持っている	因果の
因果の	定義が
定義が	確かでしょうと
物理学者とは	違う
違う	ことは
ことは	確かでしょうと
確かでしょうと	している
伊勢田は	大きいのかもしれませんと
思った	以上に
以上に	違いというのは
物理学者と	哲学者の
哲学者の	ものの
ものの	見え方の
見え方の	違いというのは
違いというのは	大きいのかもしれませんと
大きいのかもしれませんと	述べている
対談で	行ってきました
須藤は	行ってきました
これまで	けっこう長
けっこう長	行ってきました
時間	行ってきました
議論を	行ってきました
おかげで	思いますが
意見の	違いは
違いは	なったとは
明らかに	なったとは
なったとは	思いますが
思いますが	つくのでしょうかと
果たして	つくのでしょうかと
何か	つくのでしょうかと
決着が	つくのでしょうかと
つくのでしょうかと	発言し
発言し	答えている
伊勢田は	答えている
決着は	つかないでしょうねと
つかないでしょうねと	答えている
