行動を代わる	に	など	の	問題解決などの	人間に
判断をする	の	専門家の
記述をする	と	の	主体と	知能の
注目を集める	が	サポートベクターマシンが
学習を行う	に	元に
流行を超える	の	一過性の
学習を繰り返す	や	開発や
進化を見せる	て	に	て	加えて	生成技術において
生成を行う	と	CreativeAIという
開発を行う	は	の	機械式計算機の	エイダラブレスは
テストをする	に	知的ふるまいに関する
処理を行う	に	Webに
意味をする	に	データに
処理を行う	は	て	に	付加して	コンピュータに	技術は
研究を進める	て	の	費やして	第五世代コンピュータの
命令をする	で	の	機構で	Prologの
運転をする	に	元に
研究をする	に	て	の	制御についての
注目を集める	から	に	も	の	ことから	制御技術であるにも関わらず	世間の
チューニングをする	の	ルールの
成功を受ける	の	試みの
制御を用いる	の	同様の
制御をする	の	家電製品の
進歩を担う	の	科学技術の
改善を果たす	から	の	従来手法からの
研究を続ける	が	て	ジェフホーキンスが	向けて
ものを導き出す	が	DeepMindが
注目を集める	の	識者の
普及を受ける	と	発明と
投資を行う	で	民間企業主導で
探索を行う	で	無報酬で
共同研究を始める	は	Googleは
研究を行う	と	再構成するという
実験をする	の	新技術の
投資をする	は	を	まで	に	韓国は	2022年までに	20億ドルを
反乱を起こす	て	に	て	於いて	人間に対して
弾圧を併せ持つ	の	人権の
監視を行う	まで	に	人工知能に	歩行者まで
手続きを経る	を	ウイグル族を
差別を認める	から	の	のみ	に	で	の	2018年5月から	融資での	人工知能のビッグデータ分析のみによる
研究をする	の	に	て	は	達したのに対して	Amazonは
自動化を試みる	は	で	の	分野での	軍隊は
展開を変える	の	部隊の
バランスを決める	は	の	大国間の	変化は
制御をする	は	AIプログラムは
判断を介す	から	の	観点から	人間の
禁止を求める	に	は	が	の	ヒューマンライツウォッチが	同年4月には	自動操縦型武器の
競争をめぐる	を	軍事利用を
利用をめぐる	を	の	人工知能の	開発競争を
記録をする	の	米軍の
試験を行う	に	は	の	同年6月には	世界最大規模の
追及を受ける	て	で	は	で	暴露されており	公聴会では	整合性で
共同研究をする	が	と	の	Microsoftが	教育機関と	AIの
解任をする	て	は	含まれており	Google社員らは
解散をする	で	の	理由で	委員会の
存在を見いだす	で	に	アニミズムで	ものに
実現をする	の	Godheadの
崇拝を通す	と	理解と
裁判を行う	は	Waymoは
話をする	は	の	異界の	哲学者は
議論を行う	で	は	対談で	須藤は
